


NO ./textures/test
SO ./textures/test
WE ./textures/test
EA ./textures/test





F    220  ,  100   ,   0
C    225,   30,  0





111110
1 N 10
 111


