

NO ./textures/test
SO./textures/test      
WE ./textures/test
EA ./textures/test





F    220  ,  100   ,   0
C    225,   30,  0





11111
10  1
1 N 1
 111


