NO /home/florian/coding/my_cub3d_git/textures/BRICK_1A.xpm
SO /home/florian/coding/my_cub3d_git/textures/BRICK_4A.xpm
WE /home/florian/coding/my_cub3d_git/textures/SUPPORT_1A.xpm
EA /home/florian/coding/my_cub3d_git/textures/BRICK_4D.xpm





F    100  ,  100   ,   100
C    100,   100,  255





11111
10  1
1 N 1
 111


