WE textures/SUPPORT_1A.xpm
NO textures/BRICK_1A.xpm
SO textures/BRICK_4A.xpm
EA textures/BRICK_4D.xpm

F 220,100,0
C 225,30,0

          11
111111   100111111
100001    100000001
10N001    101111101
1000011111101   101
1000000000001   101
1111111111111   101
101   101        101
1011110111111111101
1000000000000000001
1111111111111111111