NO textures/BRICK_1A.xpm
SO textures/BRICK_4A.xpm
WE textures/SUPPORT_1A.xpm
EA textures/BRICK_4D.xpm


F    100  ,  100   ,   100
C    100,   100,  255

1111111111111111111111111111111111111111111111111111111111111111111111111
10                                                                      1
1                                   N                                   1
1111111111111111111111111111111111111111111111111111111111111111111111111


